⬜⬜⬜⬜⬜👑⬜⬜⬜⬜⬜
⬜⬛⬛⬛⬛⬛⬜⬛⬛⬛⬜
⬜⬛⬜⬛⬜⬛⬜⬜⬜⬛⬜
⬜⬛⬜⬛⬜⬛⬛⬛⬛⬛⬜
⬜⬛⬜⬛⬜⬜⬜⬜⬜⬛⬜
⬜⬛⬜⬛⬛⬛⬛⬛⬜⬛⬜
⬜⬛⬜⬜⬜⬜⬜⬛⬜⬜⬜
⬜⬛⬜⬛⬛⬛⬜⬛⬛⬛⬜
⬜⬜⬜⬛⬜⬛⬜⬜⬜⬛⬜
⬜⬛⬛⬛⬜⬛⬛⬛⬛⬛⬜
⬜⬜⬜⬜⬜⬛⬜⬜⬜⬜⬜